10
-.-.W.-.P.-.-.-.-.-
-.-.W.-.P.-.-.-.-.-
-.-.-.-.-.-.-.G.-.-
-.-.W.-.P.-.-.-.-.-
-.-.W.-.P.-.-.-.-.-
G.-.-.-.P.-.-.-.-.-
-.-.W.-.A.-.-.-.-.-
-.-.W.-.P.-.-.P.-.-
-.-.-.-.-.-.-.-.P.-
-.-.-.-.-.-.W.-.-.-