10
-.-.-.-.-.P.-.-.-.W
-.W.-.W.-.-.-.-.-.-
-.-.-.-.P.-.-.G.-.-
-.-.-.-.-.-.-.-.-.-
-.P.-.W.-.G.-.-.G.-
W.-.-.-.-.-.-.-.-.-
A.W.-.-.-.P.-.-.-.W
-.-.G.-.-.-.-.-.-.-
-.-.-.-.-.-.G.-.-.-
-.P.-.-.G.-.-.G.-.-
