10
-.-.-.-.W.G.-.-.-.-
-.-.P.-.-.-.-.-.G.-
-.-.-.-.-.-.-.-.-.-
-.A.-.-.W.-.-.-.-.-
-.-.-.G.-.-.-.-.G.-
-.W.-.-.-.-.-.P.-.-
-.-.-.-.-.-.-.-.-.-
-.P.-.-.W.-.-.W.-.-
-.-.-.-.-.-.-.-.-.-
-.-.-G.-.-.-.-.W.-.-
