10
-.A.-.-.-.-.-.-.-.-
-.-.-.-.-.-.-.-.-.-
-.-.-.-.-.-.-.-.-.-
-.-.-.-.-.-.-.-.-.-
-.-.-.-.-.-.-.-.-.-
-.-.-.-.-.-.-.-.P.-
-.-.-.-.-.G.-.-.-.-
-.-.-.-.-.-.-.W.-.-
-.P.-.-.-.-.-.-.-.-
-.-.-.-.-.-.-.-.-.-